ASCII map
outer bounds-17,-19,51,50
3749 charted chunks counted
Player at X140.2 Y1104
         ··W···W············II········                               
         ·············UU····II········                               
         ·····························                               
  ····································                               
  K···································                               
  K·················WWWWWWW···········                               
  ··················WWWWWWWW··········                               
  ··················WWWWWWWW··········                               
  ··················WWWWWWWWW·········                               
 ····················WWWWWWWWW·····WWW                               
 ··················WWWWWWWWWW···WWWWWWWWWWWWWWW····················· 
 ··················WWWWWWWWW····WWWWWWWWWWWWWWWW··K················· 
 ··················WWWW·WWII··WWWWWWWWWWWWW···WWWKK········S········ 
 ························WI···WWWWWWWWWWWW····W·WW·········S·········
 ·······WW··WW·········UUWW·WWWWWWWWWWWWWKK······WWWW···········CC···
 ·······W··············*UWWWWWWWWWWWWWWWWKK······WWWWW··········CC···
 ···············W········WWWWWWWWWWWWWW··········WW··················
·········WW·····*·········WWWWWWWWWWWWW···········W··················
···························WWWWWWWWWWW············WW·······II········
···························WWWWWWWWWWW············WW·······III·······
···················*·······WWWWWWWWW···········K··WW·················
···············CC··K······SSWWWWWWWW·································
···············CI·········SSWWWWWWW··································
····························WWWWW···················II···············
···························WWWWWW·············*·····I*···············
···························WWWWW·············UU··············CC·····W
···························WWW·······II······UU·············CCC····WW
·························WWWWW·······I*···············*·WW·······WWWW
················*·······WWWWWW········CC·····II·······WWWWWWW···WWWWW
··············WWW·····SS·WWWWW········CC·············WWWWWWWWW··WWWWW
·············WWWWW····SS·WWWW···············KK········WWWWWWWWWWWWWWW
············WWWWW········WWWW···············KK·········WWWWWWWWWWWWWW
···········WW·WWWW·······WWWW·····························WWWWWWWWWWW
··········WWW·WWWW········*WW·······························WWWWWWWWW
·······SS·WWW··I··········CC·····*····························WWWWWWW
·······SS··WW·*I··········CC····································WWWWW
···········WW······························WWW·······················
···········WWW·······O·*···················WWWKK·····················
············WW··························*I·CCW·······················
······CC···WWWW·························II·C*························
······CCC··WWWW······················································
··········WWWWW······················································
·········WWWWWW···············································       
········WWWWWWW·······*K····UU·····························          
·······WWWWWWWW·······KK····UU·····························          
W·····WWWWWWWWW·································WW·········          
W·····WWWWWWWWWW·······························WWWW········          
W······WWWWWWWW································WWWWW·······          
·······WWWWWWW·······························WWWWWWWW······          
·········WWW·································WWWWWWWWW·····          
        ····································WWWWWWWWWW·····          
        ·····································WWWWWWWWWW····          
        ·K·················W··········I·····WWWWWWWWWWW····          
        ·K················WWW···KK·CC·II··WW·WWWWWWWWSS····          
        ·················WWWWWWWKK·CCCII·WWWWW··WWWWWW               
        CC··············WWWWWWWWWW·CC··*·WWWWWWWWWWWW·               
        CC·········WW·WWWWWWWWWWWWWW······WWW·WWWWWW··               
        ···········WSSWWWWWWWWWWWWWW··WWWWWWWWWWWS····               
                         WWWWWWWWW·WWWWWWWWWWWW··SS···               
                         WWWWWWWWWWWWWWWWWWWWW········               
                         WWWWWWWWWWWWWWWWWWWW·········               
                         WWWWWW·WWWWWWWWWWW·I·········               
                         WWWWW·WWWWWWWWWW··III········               
                         WWWWWWWWWWWWWW····III········               
                         WWW··WWWWWWWWW···············               
                         ·····WWWWWWW·················               
                         ·····WWWWWWW·················               
                         ·····························               
                         ····························I               
                         ····························I               
